16 16 16 16 16 16 16 16 16 16 16 16 16 16 16 16 16 16 16 16 16 16 16 16 16 16 16 16 16 16 16 16 16 16 16 16 16 16 16 16 16 16 16 16 16 16 16 16 16 16 
16 16 16 16 16 16 16 16 16 16 16 16 16 16 16 16 16 16 16 16 16 16 16 16 16 16 16 16 16 16 16 16 16 16 16 16 16 16 16 16 16 16 16 16 16 16 16 16 16 16 
16 16 16 16 16 16 16 16 16 16 16 16 16 16 16 16 16 16 16 16 16 16 16 16 16 16 20 21 21 21 21 21 22 16 16 16 16 16 16 16 16 16 16 16 16 16 16 16 16 16 
16 16 16 16 16 16 16 16 16 16 16 16 16 16 16 16 16 16 16 16 16 16 16 16 16 16 25 26 26 26 26 29 24 16 16 16 16 16 16 16 16 16 16 16 16 16 16 16 16 16 
16 16 16 16 16 16 16 16 16 16 16 16 16 16 16 16 16 16 16 16 16 16 16 16 16 16 16 16 16 16 16 25 27 16 16 16 16 16 16 16 16 16 16 16 16 16 16 16 16 16 
16 16 16 16 16 16 16 16 16 16 16 16 16 16 16 16 16 16 16 16 16 16 16 16 16 16 16 16 16 16 16 16 16 16 16 16 16 16 16 16 16 16 16 16 16 16 16 16 16 16 
16 16 16 16 16 16 16 16 1 2 1 1 1 1 1 1 1 1 2 1 1 1 1 1 1 1 1 1 1 1 1 2 1 1 32 32 32 32 32 32 16 16 16 16 16 16 16 16 16 16 
16 16 16 16 16 16 16 16 1 1 1 1 2 1 1 1 1 2 1 1 1 1 16 1 1 1 16 1 1 1 2 1 1 1 32 17 17 17 17 32 16 16 16 16 16 16 16 16 16 16 
16 16 16 16 16 16 16 16 1 1 16 1 1 1 1 16 2 1 1 16 1 1 12 10 10 10 10 10 13 1 1 1 1 1 32 17 17 17 17 32 16 16 16 16 16 16 16 16 16 16 
16 16 16 16 16 16 16 16 1 1 1 1 1 16 1 1 1 1 1 1 1 2 8 38 38 38 38 38 7 32 32 32 32 32 32 34 32 32 32 32 16 16 16 16 16 16 16 16 16 16 
16 16 16 16 16 16 16 16 1 1 1 2 1 1 1 1 2 1 1 1 1 1 8 38 38 38 38 38 7 32 34 34 34 34 34 34 34 32 1 1 16 16 16 16 16 16 16 16 16 16 
16 16 16 16 16 16 16 16 1 16 1 1 32 32 32 32 32 32 32 32 32 1 14 5 5 5 5 5 15 32 35 34 34 34 34 34 34 32 1 1 16 16 16 16 16 16 16 16 16 16 
16 16 16 16 16 16 16 16 1 1 1 1 32 34 34 34 34 34 34 34 32 1 1 1 1 1 1 1 1 32 34 34 34 34 34 34 34 32 1 1 16 16 16 16 16 16 16 16 16 16 
16 16 16 16 16 16 16 16 1 16 1 1 32 34 34 34 34 34 35 34 32 1 1 16 1 16 1 1 1 32 34 34 34 34 34 34 34 32 1 1 16 16 16 16 16 16 16 16 16 16 
16 16 16 16 16 16 16 16 1 1 1 1 32 34 34 34 34 34 34 34 32 1 1 1 1 1 1 1 1 32 32 32 1 32 32 32 32 32 1 1 2 16 16 16 16 16 16 16 16 16 
16 16 16 16 16 16 16 16 1 1 1 1 32 32 32 32 1 32 32 32 32 1 1 1 12 10 10 10 10 13 1 12 10 13 1 1 1 1 1 1 2 16 16 16 16 16 16 16 16 16 
16 16 16 16 16 16 16 16 1 2 1 1 1 1 1 12 10 13 1 1 1 1 20 22 8 38 38 38 38 7 1 8 3 7 1 32 32 32 32 32 2 16 16 16 16 16 16 16 16 16 
16 16 16 16 16 16 16 16 1 1 1 2 1 1 1 8 3 7 1 1 1 1 25 27 8 38 38 38 38 7 1 8 3 7 1 32 34 34 34 32 2 16 16 16 16 16 16 16 16 16 
16 16 16 16 16 16 16 16 1 16 1 1 1 2 1 8 3 7 1 2 2 1 1 1 14 5 5 5 5 15 1 8 3 7 1 1 34 34 34 32 2 16 16 16 16 16 16 16 16 16 
16 16 16 16 16 16 16 16 1 1 1 16 1 1 1 8 3 7 1 1 1 16 1 1 2 1 1 1 1 1 1 8 3 7 1 32 34 35 34 32 2 16 16 16 16 16 16 16 16 16 
16 16 16 16 16 16 16 16 1 1 2 1 1 1 1 8 3 7 1 16 1 1 1 1 1 1 1 16 1 1 1 8 3 7 16 32 34 34 34 32 2 16 16 16 16 16 16 16 16 16 
16 16 16 16 16 16 16 16 1 1 1 1 1 1 16 8 3 7 1 1 1 1 16 1 1 2 1 1 1 1 1 8 3 7 1 32 32 32 32 32 2 16 16 16 16 16 16 16 16 16 
16 16 16 16 16 16 16 16 1 1 12 10 10 10 10 11 3 9 10 10 10 10 10 10 10 10 10 10 10 10 10 11 3 7 1 1 1 16 1 1 2 16 16 16 16 16 16 16 16 16 
16 16 16 16 16 16 16 16 33 1 8 3 3 3 3 3 3 3 3 3 3 3 3 3 3 3 3 3 3 3 3 3 3 7 2 2 1 1 1 1 16 16 16 16 16 16 16 16 16 16 
16 16 16 16 16 16 16 16 1 1 14 5 5 5 5 5 5 5 5 5 6 3 4 5 5 5 5 5 5 5 5 5 5 15 1 1 1 1 1 1 16 16 16 16 16 16 16 16 16 16 
16 16 16 16 16 16 16 16 16 16 16 16 16 16 16 1 1 1 1 1 8 3 7 16 16 16 16 16 16 16 16 16 16 16 16 16 16 16 16 16 16 16 16 16 16 16 16 16 16 16 
16 16 16 16 16 16 16 16 16 16 16 16 16 16 16 16 32 32 32 32 8 3 7 16 1 1 1 1 1 1 16 1 1 1 1 1 1 1 1 1 1 1 16 16 16 16 16 16 16 16 
16 16 16 16 16 16 16 16 16 16 16 2 2 2 16 16 32 34 34 32 8 3 7 16 1 16 16 16 16 1 16 16 16 16 1 16 16 16 16 16 16 1 16 16 16 16 16 16 16 16 
16 16 16 16 16 16 16 16 16 16 16 16 16 16 16 16 32 34 34 1 8 3 7 16 1 16 16 1 1 1 1 1 1 1 1 16 16 16 16 16 16 1 16 16 16 16 16 16 16 16 
16 16 16 16 16 16 16 16 16 16 16 2 16 16 16 16 32 34 34 32 14 5 15 16 1 16 16 1 16 16 16 16 16 16 1 16 16 16 16 16 16 1 16 16 16 16 16 16 16 16 
16 16 16 16 16 16 16 16 16 16 16 2 16 2 16 16 32 32 32 32 1 16 1 16 1 16 16 1 16 16 16 16 16 16 1 1 1 1 1 16 16 1 16 16 16 16 16 16 16 16 
16 16 16 16 16 16 16 16 16 16 16 2 16 2 16 16 16 16 16 16 16 16 1 1 1 1 1 1 1 1 16 1 1 16 1 16 16 16 1 16 16 1 16 16 16 16 16 16 16 16 
16 16 16 16 16 16 16 16 16 16 16 16 16 16 16 16 2 2 2 16 16 16 16 16 16 16 16 16 16 1 16 16 1 16 1 16 16 16 1 16 16 1 16 16 16 16 16 16 16 16 
16 16 16 16 16 16 16 16 16 16 16 16 16 16 16 16 16 16 16 16 16 16 16 16 16 16 1 16 16 1 16 16 1 16 1 16 16 16 1 16 16 1 16 16 16 16 16 16 16 16 
16 16 16 16 16 16 16 16 16 16 16 1 1 1 1 16 1 1 1 1 1 1 1 1 1 16 17 16 16 1 16 16 1 1 1 16 1 1 1 16 16 1 16 16 16 16 16 16 16 16 
16 16 16 16 16 16 16 16 16 16 16 16 1 16 16 16 16 16 16 16 16 16 16 16 1 16 17 16 16 16 16 16 16 1 1 16 16 17 16 16 16 1 16 16 16 16 16 16 16 16 
16 16 16 16 16 16 16 16 16 16 1 16 1 1 1 1 1 1 1 1 1 16 16 16 1 16 17 16 16 16 16 16 16 16 16 16 16 17 16 16 16 1 16 16 16 16 16 16 16 16 
16 16 16 16 16 16 16 16 16 16 1 16 1 16 16 16 16 16 16 16 1 16 16 16 1 16 17 17 17 17 17 17 17 17 17 17 17 17 16 16 16 1 16 16 16 16 16 16 16 16 
16 16 16 16 16 16 16 16 2 16 1 1 1 1 1 1 1 16 1 16 1 16 16 16 1 16 16 16 16 16 16 16 16 16 16 16 16 16 16 16 16 1 16 16 16 16 16 16 16 16 
16 16 16 16 16 16 16 16 16 16 16 16 16 16 16 16 1 16 1 16 1 16 16 16 1 1 1 1 1 1 1 1 1 1 1 1 1 1 1 16 16 1 16 16 16 16 16 16 16 16 
16 16 16 16 16 16 16 16 16 16 16 16 1 1 1 1 1 16 1 16 1 16 16 16 16 16 16 1 1 16 16 16 16 16 1 16 16 16 16 16 16 1 16 16 16 16 16 16 16 16 
16 16 16 16 16 16 16 16 1 16 16 16 1 16 16 16 1 16 1 16 1 1 16 16 16 16 16 1 16 16 16 16 16 16 1 16 16 16 16 16 16 1 16 16 16 16 16 16 16 16 
16 16 16 16 16 16 16 16 1 16 16 16 2 16 1 1 1 16 1 16 16 1 1 1 1 1 1 1 1 16 16 16 16 16 1 1 1 1 1 1 1 1 16 16 16 16 16 16 16 16 
16 16 16 16 16 16 16 16 1 1 2 2 1 16 1 1 1 16 1 16 16 16 16 16 16 16 16 16 1 16 16 16 16 16 16 16 16 16 16 16 16 16 16 16 16 16 16 16 16 16 
16 16 16 16 16 16 16 16 16 16 16 16 16 16 16 16 16 16 16 16 16 16 16 16 16 16 16 16 16 16 16 16 16 16 16 16 16 16 16 16 16 16 16 16 16 16 16 16 16 16 
16 16 16 16 16 16 16 16 16 16 16 16 16 16 16 16 16 16 16 16 16 16 16 16 16 16 16 16 16 16 16 16 16 16 16 16 16 16 16 16 16 16 16 16 16 16 16 16 16 16 
16 16 16 16 16 16 16 16 16 16 16 16 16 16 16 16 16 16 16 16 16 16 16 16 16 16 16 16 16 16 16 16 16 16 16 16 16 16 16 16 16 16 16 16 16 16 16 16 16 16 
16 16 16 16 16 16 16 16 16 16 16 16 16 16 16 16 16 16 16 16 16 16 16 16 16 16 16 16 16 16 16 16 16 16 16 16 16 16 16 16 16 16 16 16 16 16 16 16 16 16 
16 16 16 16 16 16 16 16 16 16 16 16 16 16 16 16 16 16 16 16 16 16 16 16 16 16 16 16 16 16 16 16 16 16 16 16 16 16 16 16 16 16 16 16 16 16 16 16 16 16 
16 16 16 16 16 16 16 16 16 16 16 16 16 16 16 16 16 16 16 16 16 16 16 16 16 16 16 16 16 16 16 16 16 16 16 16 16 16 16 16 16 16 16 16 16 16 16 16 16 16 
